甜蜜殺機	星光首映
十二夜	星光首映
跨海跳探戈	星光首映
一線三星	星光首映
當冷風吹起	星光首映
應莫帖	星光首映
Knighthood	星光首映
為你點首歌	星光首映
急救時刻	星光首映
彼端	星光首映
我們都是「蒙娜麗莎」	星光首映
淹煙	星光首映
泳漾	星光首映
郊遊	開幕片
親・愛	華語透視界
今天明天	華語透視界
我的影子在奔跑	華語透視界
怨鬼	華語透視界
冠軍歌王	華語透視界
飛虎出征	華語透視界
末日‧ 派對	華語透視界
天堂：愛	名家饗宴
天堂：信	名家饗宴
天堂：望	名家饗宴
危機解密	名家饗宴
愛，墮落	名家饗宴
情慾維那斯	名家饗宴
寂寞拍賣師	名家饗宴
最後的卡蜜兒	名家饗宴
美麗．誘惑	名家饗宴
劫婚進行曲	名家饗宴
美好的那些年	名家饗宴
三不管人生	名家饗宴
拉合爾茶館的陌生人	名家饗宴
新聞鬼上身	名家饗宴
完美的蛇頸龍之日	名家饗宴
共食家族	名家饗宴
地獄開麥拉	名家饗宴
她和她的小鬼們	影迷嘉年華
無路用之王	影迷嘉年華
戀夏進行式	影迷嘉年華
坎城完全製片指南	影迷嘉年華
我唱我想愛	影迷嘉年華
英倫怪咖	影迷嘉年華
她的搖擺上路	影迷嘉年華
直男G體驗	影迷嘉年華
愛慾來襲時	影迷嘉年華
我曾擁有那座城堡	影迷嘉年華
餐館小情歌	影迷嘉年華
美麗失敗者	影迷嘉年華
愛的餘燼	影迷嘉年華
神父精煩惱	影迷嘉年華
失序警戒線	影迷嘉年華
奧瑪的抉擇	影迷嘉年華
唱你媽的歌！	影迷嘉年華
郊遊	金馬獎入圍影片
過界	金馬獎入圍影片
十二生肖	金馬獎入圍影片
阿嬤的夢中情人	金馬獎入圍影片
志氣	金馬獎入圍影片
失魂	金馬獎入圍影片
爸媽不在家	金馬獎入圍影片
一九四二	金馬獎入圍影片
天注定	金馬獎入圍影片
暑假作業	金馬獎入圍影片
狂舞派	金馬獎入圍影片
致我們終將逝去的青春	金馬獎入圍影片
一代宗師	金馬獎入圍影片
聖誕玫瑰	金馬獎入圍影片
激戰	金馬獎入圍影片
寒戰	金馬獎入圍影片
李碧華鬼魅系列：迷離夜	金馬獎入圍影片
親愛的奶奶	金馬獎入圍影片
西遊降魔篇	金馬獎入圍影片
毒戰	金馬獎入圍影片
盲探	金馬獎入圍影片
殭屍	金馬獎入圍影片
總舖師	金馬獎入圍影片
甜‧ 祕密	金馬獎入圍影片
南方小羊牧場	金馬獎入圍影片
海闊天空	金馬獎入圍影片
春夢	金馬獎入圍影片
青春派	金馬獎入圍影片
邊城啟示錄	金馬獎入圍影片
餘生	金馬獎入圍影片
拔一條河	金馬獎入圍影片
看見台灣	金馬獎入圍影片
一首搖滾上月球	金馬獎入圍影片
流放地	金馬獎入圍影片
神算	金馬獎入圍影片
狀況排除	金馬獎入圍影片
酥油燈	金馬獎入圍影片
緹縈 (免費入場)	金馬獎終身成就獎—甄珍
奧斯卡的一天	一鳴驚人
青春殘酷練習曲	一鳴驚人
初綻的青春	一鳴驚人
腳踏車大作戰	一鳴驚人
莎拉愛跑步	一鳴驚人
幫老爸拍張照	一鳴驚人
聽冥王星唱歌	一鳴驚人
我要去美國	一鳴驚人
小蝦米的逆襲	一鳴驚人
瑞凡費尼克斯未完成	不設防地帶
該死的中產階級	不設防地帶
第五個季節	不設防地帶
柏林貓咪日記	不設防地帶
在世界邊緣遇見熊	不設防地帶
性教慾	不設防地帶
布加勒斯特夜未眠	不設防地帶
瘋愛	不設防地帶
阿信	亞洲視窗
那夜的武士	亞洲視窗
櫻花下的約定	亞洲視窗
少年H	亞洲視窗
闇黑新世界	亞洲視窗
舞孃禁戀	亞洲視窗
我唱B嘟B嘟	亞洲視窗
瑪麗快樂真快樂	亞洲視窗
救救菜英文	亞洲視窗
孟買追擊夜	亞洲視窗
寶萊塢愛情特快車	亞洲視窗
媽咪速成計畫	亞洲視窗
南方來信	亞洲視窗
泳敢愛	性別越界
湖畔春光	性別越界
愛滋長	性別越界
十種懷孕的方法	性別越界
龐克小貓拆政府	傳奇人生
石玫瑰：傳奇再臨	傳奇人生
搖滾紀年：滾石1965	傳奇人生
搖滾瞬間	傳奇人生
雷夫史戴德曼之叛逆速記	傳奇人生
莎拉波莉家庭詩篇	傳奇人生
母親節	傳奇人生
木下惠介：微光中的電影路	傳奇人生
昨天	傳奇人生
科學怪軍團	午夜特快車
觀光客出沒，注意！	午夜特快車
洛城警察壞壞事件	午夜特快車
這該死的愛	午夜特快車
宇宙船長哈洛克	午夜特快車
愛溢狂洩	午夜特快車
做愛．嗑藥．逃漏稅	午夜特快車
藍色是最溫暖的顏色	焦點導演：阿布戴柯西胥
黑色維納斯	焦點導演：阿布戴柯西胥
家傳秘方	焦點導演：阿布戴柯西胥
愛情躲貓貓	焦點導演：阿布戴柯西胥
都是伏爾泰的錯	焦點導演：阿布戴柯西胥
金甲部隊	經典重現
羅馬假期	經典重現
俘虜	經典重現
陽光普照	經典重現
美好的五月	經典重現
霸王別姬	經典重現
小畢的故事	經典重現
梁山伯與祝英台	經典重現
二十四隻眼睛	經典重現
咎愛	焦點導演：阿斯哈法哈蒂
分居風暴	焦點導演：阿斯哈法哈蒂
海灘的那一天	焦點導演：阿斯哈法哈蒂
煙花星期三	焦點導演：阿斯哈法哈蒂
死期預告	焦點導演：阿斯哈法哈蒂
在微塵中漫舞	焦點導演：阿斯哈法哈蒂
童年幻舞	焦點導演：阿力山卓尤杜洛斯基
聖血	焦點導演：阿力山卓尤杜洛斯基
聖山	焦點導演：阿力山卓尤杜洛斯基
鼴鼠	焦點導演：阿力山卓尤杜洛斯基
凡多與莉絲:謎之旅	焦點導演：阿力山卓尤杜洛斯基
天注定	金馬50：大師現身
海上花	金馬50：大師現身
色,戒	金馬50：大師現身
黑眼圈	金馬50：大師現身
甜蜜蜜	金馬50：大師現身
天水圍的日與夜	金馬50：大師現身
頤和園	金馬50：大師現身
阮玲玉	金馬50：大師現身
黑社會	金馬50：大師現身
